литовское население	литовское население
католическое духовенство	католическое духовенство
международных организаций	международная организация
ООН	оон
ЮНЕСКО	юнеско
горные системы	горная система
Восточный Саяны	восточная саяна
Становое нагорье	становое нагорье
средневысотных горных хребтов	средневысотный горный хребет
Сихотэ-Алинь	сихотэ-алинь
Верхоянский	верхоянский
Черского	черский
ландшафты	ландшафт
широколиственнолесные	широколиственнолесный
характеристиками	характеристика
атмосферной циркуляцией	атмосферная циркуляция
континентальностью климата	континентальность климата
последствиями	последствие
переход	переход
преобразования	преобразование
налоговой системы	налоговая система
международных организаций	международная организация
Совет Европы	совет европы
ОБСЕ	обсе
страны	страна
страны Евросоюза	страны Евросоюза
США	сша
Канаду	канада
Великобританию	великобритания
Китай	китай
Японию	япония
страны	страна
Испания	испания
Канада	канада
Мексика	мексика
Индонезия	индонезия
металлов	металл
добыча угля	добыча угля
нефти	нефть
газа	газа
апатитов	апатит
никеля	никель
регионах	регион
Чечня	чечня
свободу вероисповедания	свобода вероисповедания
право	право
учёных в СССР	учёных в СССР
Курчатова	курчатов
Королёва	королёв
мастера	мастер
Алипий	алипий
выдающиеся танцовщики	выдающийся танцовщик
Матильда	матильда
городах	город
опытных радиовещательных станций в Москве	опытных радиовещательных станций в Москве
Казани	казань
тактильный контакт	тактильный контакт
важен в общении слонихи	важен в общении слонихи
слонёнка	слонёнок
различные сладкие плоды	различный сладкий плод
яблоки	яблоко
бананы	банан
виды животных	вид животного
мелких	мелкий
характерных частиц	характерная частица
наноалмазов	наноалмаз
ударных сферул	ударная сферула
объекты	объект
Река Мамонта	река мамонта
дисциплин —	дисциплина —
синергетика	синергетика
имиджеология	имиджеология
акмеология	акмеология
соционика	соционик
Бриггс	бриггс
наличие	наличие
различных дихотомических тестов	различный дихотомический тест
различные адаптированные версии	различная адаптированная версия
объединения	объединение
кружки	кружка
секции	секция
странах	страна
Америке	америка
Австралии	австралия
гуманитарные науки	гуманитарная наука
психология	психология
политология	политология
культурология	культурология
антропология	антропология
исторические процессы	исторический процесс
политические изменения	политическое изменение
понятия	понятие
социальный класс	социальный класс
гендер	гендёр
раса	раса
этничность	этничность
направления	направление
социология культуры	социология культуры
социология массмедиа	социология массмедиа
социология искусства	социология искусства
социология науки	социология науки
социология религии	социология религии
социология нравственности	социология нравственности
явления	явление
доверие	доверие
стереотипы	стереотип
мода	мода
вкусы	вкус
нравы	нрав
обычаи	обычай
церемонии	церемония
образ жизни	образ жизни
нормы семьи	нормы семьи
труда	труд
досуга	досуг
университетах	университет
прикладной социологии в Новосибирском	прикладной социологии в Новосибирском
Казанском	казанский
Уральском	уральск
Томском	томск
Иркутском	иркутск
авторов начала	авторов начала
Преснякова	пресняков
представители норманизма	представитель норманизма
Василий Ключевский	Василий Ключевский
категорий населения	категорий населения
челядь	челядь
холопы	холоп
смерды	смерд
закупы	закуп
рядовичи	рядович
факторами	фактор
христианизацией	христианизация
князей	князь
I	i
Святополка	святополк
Ярослава Мудрого	ярослава мудрого
ряде городов	ряд города
Новгород	новгород
Киев	киев
Рязань	рязань
Смоленск	смоленск
части	часть
ров	ров
городские стены	городская стена
виды ремёсел	вид ремесла
гончарное	гончарное
кожевенное	кожевенное
древодельное	древодельное
камнесечное	камнесечное
огромное значение	огромное значение
внешняя	внешняя
обстоятельствами	обстоятельство
войнами	война
городах	город
археологических раскопок в Новгороде	археологических раскопок в Новгороде
городов	город
церквей Киева	церквей Киева
Новгорода	новгород
Смоленска	смоленск
Владимира	владимир
жанров	жанр
проповедь	проповедь
жития	житие
славянские народы	славянский народ
Великой Моравии	великая моравия
события	событие
варяг в греки	варяг в греки
Российской империи	российская империя
Третьяковы	третьяков
Мамонтов	мамонт
отраслях	отрасль
промышленности	промышленность
городах	город
Москве	москва
Киеве	киев
Харькове	харьков
Одессе	одесса
Чернигове	чернигов
Подольске	подольск
Воронеже	воронеж
Иваново-Вознесенске	иваново-вознесенск
городах	город
Витебск	витебск
Полоцк	полоцк
Кострома	кострома
население	население
районов	район
Московской застав	московская застава
Невского	невский
твёрдыми частями	твёрдая часть
Петроградские юнкерские училища	петроградское юнкерское училище
районов Петрограда	районов Петрограда
Нарвского	нарвский
Петергофского	петергофский
Александро-Невского	александро-невский
меньшевики-оборонцы	меньшевик-оборонец
Кузьма Гвоздев	Кузьма Гвоздев
Марк Бройдо	Марк Бройдо
Борис Богданов	Борис Богданов
общеполитической ситуации	общеполитическая ситуация
рост	рост
офицерами	офицер
командира полка	командир полки
великих князей	великий князь
популярного	популярный
общественных организаций	общественная организация
представители Советов	представитель совета
профсоюзов	профсоюз
страны	страна
Россия	россия
либералами	либерал
Милюковым	милюков
насущные вопросы	насущный вопрос
вопрос	вопрос
теоретики большевизма	теоретик большевизма
ленин	ленин
районов	район
городах Поволжья	город поволжья
Сибири	сибирь
крупных городов	крупный город
губернских	губернский
городах	город
власть в Луганске	власть в Луганске
Макеевке	макеевка
Горловке	горловка
Краматорске	краматорск
Центральных держав	центральная держава
Германии	германия
ценности	ценность
кредитными знаками	кредитный знак
слитки золота	слиток золота
платины	платина
Закаспийская область	закаспийская область
города Красноводск	город красноводска
Асхабад	асхабад
Мерв	мерв
антибольшевистских формированиях	антибольшевистское формирование
Закаспийского правительства	закаспийское правительство
сабель	сабля
стариков	старик
подростков	подросток
запада часть войск	запад части войска
латышских стрелков	латышский стрелок
социальных программ	социальная программа
бесплатное здравоохранение	бесплатное здравоохранение
образование	образование
жильё	жильё
отряды	отряд
бронепоезда	бронепоезд
авиационные	авиационный
легальных партий	легальная партия
кадетской	кадетская
социалистическими странами	социалистическая страна
СССР	ссср
имена	имя
Андрей Сахаров	андрей сахара
Александр Солженицын	Александр Солженицын
членство СССР в ООН	членство СССР в ООН
постоянное членство в Совете Безопасности	постоянное членство в Совете Безопасности
силовых структур	силовая структура
государственно-партийная номенклатура	государственно-партийная номенклатура
генералитет армии	генералитет армии
МВД	мвд
формирования	формирование
РВСН	рвсна
СВ	св
Войска ПВО	Войска ПВО
ВВС	ввс
выдающихся архитекторов	выдающийся архитектор
И. В.	И. В.
средствах	средство
печати	печать
государственной власти	государственная власть
НКВД	нквд
страны	страна
Великобритания	великобритания
Федеративная Республика	федеративная республика
таковое	таковое
справедливо в отношении народов	справедливо в отношении народов
социальных сферах	социальная сфера
образовании	образование
объединения	объединение
ЕврАзЭс	евразэс
создаваемое Единое экономическое пространство	создаваемое единое экономическое пространство
товаров	товар
объёмов производства оружия	объёмов производства оружия
военной техники	военная техника
бригад	бригада
войска союзников	войска союзников
захватом портов на Балтийском море	захватом портов на Балтийском море
Ленинград	ленинград
Кронштадт	кронштадт
фронтовых операций	фронтовая операция
Житомирско-Бердичевской	житомирско-бердичевский
Кировоградской	кировоградская
Корсунь-Шевченковской	корсунь-шевченковская
Луцко-Ровненской	луцко-ровненский
Никопольско-Криворожской	никопольско-криворожский
Проскуровско-Черновицкой	проскуровско-черновицкий
Уманско-Ботошанской	уманско-ботошанский
Березнеговато-Снигирёвской	березнеговато-снигирёвская
Одесской	одесская
народов СССР	народов СССР
русского	русский
государств	государство
Панама	панама
Коста-Рика	коста-рика
Доминиканская Республика	доминиканская республика
Сальвадор	сальвадор
Гаити	гаити
Гондурас	гондурас
Никарагуа	никарагуа
Гватемала	гватемала
Куба	куб
Непал	непал
Аргентина	аргентина
Чили	чили
Перу	перу
Колумбия	колумбия
Иран	иран
Албания	албания
сфер интересов в Восточной Европе	сфер интересов в Восточной Европе
прибалтийские государства	прибалтийское государство
Польшу	польша
эпохи Просвещения	эпохи Просвещения
Монтескье	монтескье
Вольтер	вольтер
системы	система
политические изменения	политическое изменение
активные участники	активный участник
Лукьянов	лукьянов
республиках Союза	республика союза
РСФСР	рсфср
городов Азербайджана	городов Азербайджана
Баку	баку
Сумгаита	сумгаит
Мингечаура	мингечаур
Казаха	казах
Шамхора	шамхор
ликёро-водочных продуктов	ликёро-водочный продукт
производства водки	производства водки
средствах	средство
печати	печать
союзных республик	союзная республика
РСФСР	рсфср
заводы	завод
Смольный двор	смольный двор
Литейный двор	литейный двор
водяные пильные мельницы	водяная пильная мельница
кирпичные	кирпичный
восковый	восковый
пороховые	пороховой
оружейный	оружейный
шпалерный	шпалерный
кожевенный	кожевенный
зодчие	зодчий
К. И.	К. И.
события	событие
года в городе	года в городе
административными зданиями	административное здание
Домом Советов	дом совета
пищевые продукты	пищевой продукт
напитки	напиток
известные	известный
Санкт-Петербургский государственный университет	санкт-петербургский государственный университет
Санкт-Петербургский государственный архитектурно-строительный университет	санкт-петербургский государственный архитектурно-строительный университет
Санкт-Петербургский государственный медицинский университет	санкт-петербургский государственный медицинский университет
государственных академий	государственная академия
организаций Академии наук РФ	организаций Академии наук РФ
научно-исследовательских учреждений	научно-исследовательское учреждение
академических институтов	академический институт
госучреждения	госучреждение
переливания крови	переливания крови
предметы искусства	предмет искусства
отдела Востока	отдела Востока
ковры	ковёр
здания	здание
стороне Невы	сторона невы
фондохранилище в Старой Деревне	фондохранилище в Старой Деревне
мастеров	мастер
Дирк	дирк
произведения	произведение
Хонтхорст	хонтхорст
художников	художник
Гога	гога
Матисса	матисс
Пикассо	пикассо
музеев Берлина	музеев Берлина
Пергамский алтарь	пергамский алтарь
ряд экспонатов	ряд экспоната
авторов	автор
работы Утрилло	работа утрилло
Руо	руо
Сутина	сутина
бывшего СССР	бывший ссср
богатейшая в мире коллекция	богатейшая в мире коллекция
площади	площадь
выставочные	выставочный
служебные площади	служебная площадь
отрасли	отрасль
машиностроение	машиностроение
лёгкая	лёгкая
химическая промышленность	химическая промышленность
организаций	организация
ЮНЕСКО	юнеско
ЕС	ес
формирование	формирование
вулканических форм	вулканическая форма
потухших вулканов	потухший вулкан
реки страны	реки страны
Рейн	рейн
миллиона жителей	миллиона жителей
заморские территории	заморская территория
Франция	франция
больших дворцово-парковых ансамблей	больший дворцово-парковый ансамбль
Версаль	версаль
Люксембургский сад	люксембургский сад
крупных художников	крупный художник
Поль Гоген	Поль Гоген
Винсент	винсент
известные композиторы	известный композитор
Камиль Сен-Санс	Камиль Сен-Санс
Габриэль Форе	габриэль форы
Сезар Франк	сезара франка
известных композиторов	известный композитор
Артура Онеггера	артур онеггеры
Дариуса Мийо	Дариуса Мийо
Франсиса Пуленка	франсис пуленки
электронные жанры	электронный жанр
трип-хоп	трип-хоп
центральная Польша	центральная польша
Варшава	варшава
племена	племя
западные поляне	западный полянин
знатных лиц	знатное лицо
московских бояр	московский бояр
возвращение в СССР советников	возвращение в СССР советников
министра обороны	министра обороны
политическими силами	политическая сила
Польской крестьянской партией	польская крестьянская партия
Священные войны	священная война
известны	известный
атлетические соревнования	атлетическое соревнование
состязания на колесницах	состязания на колесницах
Греции	греция
архипелаги	архипелаг
острова	остров
области в Малой Азии	области в Малой Азии
меньшинствам	меньшинство
языковым	языковой
типы сооружений	тип сооружения
театр	театр
стадион	стадион
палестра	палестра
композиторов	композитор
Манос Хадзидакис	манос хадзидакиса
Теодоракис	теодоракис
национальных инструментов	национальный инструмент
бузуки	бузук
поздних авторов	поздний автор
написанные	написанный
войско неприятеля	войско неприятеля
главнокомандующего Давриса	главнокомандующий даврис
множество дельфинов	множество дельфина
косаток	косатка
крачек	крачка
розовую	розовая
виды	вид
траловый лов	траловый лов
судоходство	судоходство
природных ресурсов	природный ресурс
туризм	туризм
продажа кораллов	продажа коралла
международных организациях	международная организация
ООН	оон
архипелагов	архипелаг
Фернанду-ди-Норонья	фернанду-ди-норонья
Рокас	рокас
Сан-Паулу	сан-паулу
Триндади-э-Мартин-Вас	триндади-э-мартин-вас
международных организациях	международная организация
ООН	оон
БРИКС	брикс
многочисленных новых участников	многочисленный новый участник
финансовые фирмы	финансовая фирма
мире	мир
капоэйра	капоэйр
бразильское джиу-джитсу	бразильское джиу-джитсу
греческого искусства	греческое искусство
Квадрига на соборе	Квадрига на соборе
европейских членах	европейский член
Италии	италия
Европе	европа
Италию	италия
этнические меньшинства	этническое меньшинство
албанцы	албанец
марокканцы	марокканец
островами	остров
Сицилией	сицилия
Сардинией	сардиния
продовольственные товары	продовольственный товар
фрукты овощи	фрукты овощи
консервированные помидоры	консервированный помидор
сыры	сыр
готовое платье	готовое платье
обувь	обувь
продукция химии	продукция химии
нефтехимии	нефтехимия
художественными течениями	художественное течение
маккьяйоли	маккьяйоль
футуризм	футуризм
метафизическая живопись	метафизическая живопись
новеченто	новеченто
арте повера	арт поверы
трансавангард	трансавангард
города	город
Флоренция	флоренция
Венеция	венеция
Милан	милан
Неаполь	неаполь
Турин	турин
зданиями Дворец дожей	здание дворца дожа
Святого Марка	святая марка
библиотекой Сан-Марко	библиотекой сан-марко
известных художников	известный художник
шедевры Тициана	шедевр тициана
Веронезе	веронез
Тинторетто	тинторетто
разными художниками	разный художник
Тинторетто	тинторетто
патологических процессов	патологический процесс
бактериальная	бактериальная
вирусная инфекция	вирусная инфекция
направления	направление
космическая биология	космическая биология
социобиология	социобиология
физиология труда	физиология труда
бионика	бионика
античных учёных	античный учёный
Аристотель	аристотель
Гален	гален
современные биологические дисциплины	современная биологическая дисциплина
ботаника	ботаник
зоология	зоология
химики	химик
лавуазье	лавуазье
натуралисты	натуралист
Александр Гумбольдт	Александр Гумбольдт
крупные дикие животные	крупное дикое животное
кабан	кабан
лось	лось
числа пробок	числа пробок
запрет на въезд в город	запрет на въезд в город
транспортного кольца	транспортное кольцо
придомовые территории	придомовая территория
городами России	город россии
Санкт-Петербургом	санкт-петербург
Астраханью	астрахань
Ростовом-на-Дону	ростов-на-дону
отраслях	отрасль
ядерная энергетика	ядерная энергетика
микроэлектроника	микроэлектроника
космонавтика	космонавтика
науки	наука
историю России	история россии
медицину	медицина
физику	физика
русский язык	русский язык
копиями	копия
копии гостиницы	копии гостиницы
муниципальных образований	муниципальное образование
газеты округов	газеты округов
районов	район
выдающиеся москвичи	выдающийся москвич
II	ii
сферы деятельности на русский язык	сферы деятельности на русский язык
делопроизводство	делопроизводство
морским промыслам	морской промысл
охоту на тюленя	охоту на тюленя
Витебской губернии	витебская губерния
Двинский	двинский
Люцинский	люцинский
Режицкий	режицкий
часть	часть
Прибалтики	прибалтика
Калининградскую область	калининградская область
центры	центр
хазарский Итиль в устье	хазарский Итиль в устье
булгарский Булгар на Средней Волге	булгарский Булгар на Средней Волге
русские Ростов	русский ростов
Суздаль	суздаль
Муром в Верхнем Поволжье	Муром в Верхнем Поволжье
центров	центр
Казань	казань
Нижний Новгород	нижний новгород
Астрахань	астрахань
племена	племя
тюринги	тюринг
бавары	бавар
саксы	сакс
восточногерманских государствах	восточногерманское государство
Пруссии	пруссия
новые пригороды	новый пригород
Веддинг	веддинга
Моабит	моабит
Темпельхоф	темпельхоф
Шёнеберг	шёнеберг
произведений искусства	произведений искусства
европейской живописи	европейская живопись
программу	программа
цирк на льду	цирк на льду
цирк на воде	цирк на воде
Кировской области	кировская область
территорию	территория
России	россия
боеприпасы	боеприпас
городами	город
Москвой	москва
первоначальные деревянные постройки	первоначальная деревянная постройка
уникальную Успенскую церковь	уникальная успенская церковь
Муравьёва-Амурского	муравьёва-амурское
посёлок Трудовое	посёлок Трудовое
производственных объектов	производственный объект
МУПВ Спецзавод	мупв спецзавода
населённых пунктов	населённый пункт
Владивостока	владивосток
местными вузами	местный вуз
Владивостокский государственный университет	владивостокский государственный университет
христианские общины	христианская община
пятидесятнические	пятидесятнический
пресвитерианские	пресвитерианский
харизматические	харизматический
крупных рек	крупная река
Рейн	рейн
Эльба	эльба
Везер	везер
Шельда	шельда
Темза	темза
полноводные реки	полноводная река
Шельда	шельда
Маас	маас
рек	река
устья Рейна	устья Рейна
Мааса	маас
Шельды	шельда
виды рыб	вид рыбы
атлантическую	атлантическая
креветок	креветка
палтус	палтус
континентами	континент
Европой	европа
геральдическими атрибутами	геральдический атрибут
грозными львами	грозный лев
населённые пункты	населённый пункт
провинции Шлезвиг-Гольштейна — Альтона	провинция шлезвига-гольштейна — альтона
город Бергедорф	город Бергедорф
специальные учреждения	специальное учреждение
университет	университет
грузов	груз
насыпных	насыпной
наливных	наливной
контейнерных	контейнерный
оборонительные сооружения	оборонительное сооружение
Тауэр	тауэр
эмигранты	эмигрант
Павел Николаевич Милюков	Павел Николаевич Милюков
мелкие притоки	мелкий приток
исторический Уолбрук	исторический уолбрук
пригородной зоной	пригородная зона
города-спутники	город-спутник
белым	белый
выходцев	выходец
финансы	финансы
банковский сервис	банковский сервис
страхование	страхование
управление активами	управление актива
наземных железных дорог	наземная железная дорога
внутригородской транспорт	внутригородской транспорт
известные люди	известный человек
Карл Маркс	Карл Маркс
реки Азии	реки Азии
Амур	амур
Хуанхэ	хуанхэ
Янцзы	янцзы
Меконг	меконг
—	—
Юкон	юкон
Колорадо	колорадо
Колумбия	колумбия
Фрейзер	фрейзер
Гуаяс	гуаяс
отходов	отход
пластика	пластик
— Австралия	— австралии
циркона	циркон
ильменита	ильменит
части	часть
побережья Нидерландов	побережья Нидерландов
млекопитающих	млекопитающее
дельфинов	дельфин
отходов	отход
пластика	пластик
знаменитые пираты	знаменитый пират
Джон Хокинс	Джон Хокинс
Фрэнсис Дрейк	Фрэнсис Дрейк
Генри Морган	Генри Морган
страны	страна
США	сша
Бразилия	бразилия
стран Средиземноморья	стран Средиземноморья
Турция	турция
Хорватия	хорватия
Египет	египет
Тунис	тунис
Марокко	марокко
породы деревьев	породы деревьев
американский	американский
яблоня	яблоня
рябина	рябина
порты	порт
Санкт-Петербурга в Москву	Санкт-Петербурга в Москву
Астрахань	астрахань
Ростов-на-Дону	ростов-на-дону
Пермь	пермь
Нижний Новгород	нижний новгород
остров Валаам	остров Валаам
высших органов	высочайший орган
местопребывание правительства	местопребывание правительства
дорожной сети	дорожная сеть
скоростные магистрали	скоростная магистраль
крупных городах	крупный город
уровень рождаемости	уровень рождаемости
постройки	постройка
здания	здание
жилые дома	жилой дом
городов	город
Генуя	генуя
Венеция	венеция
Париж	париж
Амстердам	амстердам
Великий Новгород	великий новгород
Данциг	данциг
регионов	регион
Москвы	москва
Украину	украина
непризнанные	непризнанный
Молдавию	молдавия
непризнанное Приднестровье	непризнанное приднестровье
страны	страна
Великобританию	великобритания
Ирландию	ирландия
Францию	франция
сферах	сфера
права человека	права человека
гражданство	гражданство
международное частное право	международное частное право
защита	защита
древнегреческие учёные	древнегреческий учёный
Геродот	геродот
международных организациях	международная организация
Международная почтовая организация	международная почтовая организация
спортивные команды	спортивная команда
НАТО	нато
Международная организация	международная организация
горы Шотландии	горы Шотландии
Бен-Невис	бен-невис
лоуленд	лоуленд
Среднешотландская низменность	среднешотландская низменность
Южном Уэльсе	южный уэльс
прибрежные города	прибрежный город
унитарных образований	унитарное образование
Кардифф	кардифф
Суонси	суонси
Ньюпорт	ньюпорт
колониальное развитие	колониальное развитие
работорговлю	работорговля
территории	территория
Индию	индия
значительные владения в Африке	значительные владения в Африке
волнения	волнение
политические	политический
социальные беспорядки	социальный беспорядок
дерегуляции	дерегуляция
финансового сектора	финансовый сектор
рынка труда	рынка труда
XXI века	xxi век
вторжение в Ирак	вторжение в Ирак
Афганская кампания	афганская кампания
различных письменных источников	различный письменный источник
статуты	статут
судебных прецедентов	судебный прецедент
международных договоров	международный договор
возможностями в Вестминстере	возможностями в Вестминстере
офисами	офис
Британского парламента	британский парламент
образование	образование
здравоохранение	здравоохранение
законы Шотландии	закон шотландии
местное самоуправление	местное самоуправление
дополнительной власти	дополнительная власть
контроль	контроль
высших британских чиновников	высочайший британский чиновник
главы	глава
областях	область
национальная оборона	национальная оборона
безопасность	безопасность
шпионаж	шпионаж
Великобритании	великобритания
Особая воздушная служба	особая воздушная служба
Особая лодочная служба	особая лодочная служба
богатых лиц	богатое лицо
граждан России	граждан России
ролей в авиационной промышленности	ролей в авиационной промышленности
компанию	компания
автомобильной промышленности	автомобильная промышленность
двигателей	двигатель
бывших колоний	бывшая колония
Австралию	австралия
Канаду	канада
Индию	индия
Ирландию	ирландия
Новую Зеландию	новая зеландия
ЮАР	юар
США	сша
драматурги	драматург
Алан Эйкборн	Алан Эйкборн
Гарольд Пинтер	Гарольд Пинтер
Майкл Фрейн	Майкл Фрейн
Том Стоппард	том стоппарда
культурных течений	культурное течение
элементы сюрреализма	элемент сюрреализма
реализма	реализм
персоны	персона
Уильям Бёрд	уильям бёрда
Генри Пёрселл	генри пёрселлы
Эдуард Элгар	Эдуард Элгар
Густав Холст	Густав Холст
Артур Салливан	Артур Салливан
имена	имя
Саймон Рэттл	Саймон Рэттл
Джон Барбиролли	Джон Барбиролли
Малколм Сарджент	малколм сардженты
произведения	произведение
Мессию	мессия
радикальные течения	радикальное течение
викторианская сказочная живопись	викторианская сказочная живопись
признания	признание
Джули Эндрюс	джуля эндрюса
Ричарда Бёртона	Ричарда Бёртона
Майкла Кейна	майкл кейной
Шона Коннери	шон коннеря
Вивьен Ли	вивьен ли
Дэвида Нивена	дэвид нивены
Лоренса Оливье	лоренс оливьи
Питера Селлерса	питер селлерсы
Кейт Уинслет	Кейт Уинслет
Энтони Хопкинса	энтони хопкинса
Хью Грант	хью гранта
странами	страна
государствами Содружества	государство содружества
территория	территория
остров Ирландия	остров Ирландия
дисциплины	дисциплина
арифметика	арифметика
геометрия	геометрия
музыка	музыка
астрономия	астрономия
странах	страна
СССР	ссср
части	часть
полка СС	полка сс
новые предприятия	новое предприятие
Белкоммунмаш	белкоммунмаш
предприятиями	предприятие
железобетонных изделий	железобетонное изделие
архитекторами	архитектор
Людмилой Гафо	людмила гафо
Евгением Заславским	Евгением Заславским
представителей интеллигенции	представителей интеллигенции
адресам учёных	адрес учёного
писателей	писатель
учителей	учитель
адвокатов	адвокат
тысяч	тысяча
резким в Болгарии	резким в Болгарии
Венгрии	венгрия
странах	страна
Бурунди	бурунди
Демократическая Республика	демократическая республика
азиатских государствах	азиатское государство
Непале	непал
Филиппинах	филиппина
Индонезии	индонезия
Монголии	монголия
странах	страна
России	россия
Чехии	чехия
Италии	италия
США	сша
Бельгии	бельгия
Нидерландах	нидерландах
городах	город
Интернету отель в Роттердаме	Интернету отель в Роттердаме
Римини	римини
Белостоке	белосток
новых интернет-технологий	новый интернетом-технология
подкастинг	подкастинг
неточные сведения	неточное сведение
негативные мифы	негативный миф
эсперанто-сообществе	эсперанто-сообщество
популярна идея	популярная идея
объектов	объект
названия улиц	названия улиц
парков	парк
областях	область
химия	химия
нефтехимия	нефтехимия
биология	биология
биотехнология	биотехнология
медицина	медицина
летучие органические кислоты	летучая органическая кислота
уксусная кислота	уксусная кислота
веществ	вещество
карбоновые кислоты	карбоновая кислота
неорганические соединения	неорганическое соединение
оксид кремния	оксид кремния
органические полимеры	органический полимер
полистирол	полистирол
цвиттер-ионных соединений	цвиттер-ионное соединение
азокрасителей	азокраситель
материалы	материал
силикагель	силикагель
оксид алюминия	оксид алюминия
микрокристаллическая целлюлоза	микрокристаллическая целлюлоза
агароза	агароз
элементы	элемент
цинк	цинк
железо	железо
магний	магний
медь	медь
микроскопов	микроскоп
биологических микроскопов	биологический микроскоп
агрессивных средах	агрессивная среда
коррозийных газах	коррозийный газ
электронных носителях	электронный носитель
записанного материала на компьютере	записанного материала на компьютере
превращения	превращение
таутомерию	таутомерия
английским	английский
жители	житель
ряда обязательств	ряда обязательств
введение	введение
энергии	энергия
энергии ветра	энергии ветра
страны	страна
Туркестан	туркестан
пресных водоёмов	пресный водоём
озёр	озеро
мира	мир
Амазонка	амазонка
Инд	инд
Ганг	ганг
Нил	нил
Миссисипи	миссисипи
причин	причина
воды на побережье	воды на побережье
малоподготовленных читателей	малоподготовленный читатель
детей	ребёнок
подростков	подросток
изданиями	издание
справочными	справочный
справочные издания	справочное издание
интересными	интересный
науками	наука
квантовой химией	квантовая химия
химической физикой	химическая физика
физической химией	физическая химия
геохимией	геохимия
биохимией	биохимия
ремёсла	ремесло
металлургия	металлургия
гончарство	гончарство
стеклоделие	стеклоделие
крашение	крашение
парфюмерия	парфюмерия
косметика	косметика
элементов	элемент
ртуть	ртуть
сера	сера
фосфор	фосфор
процессов	процесс
технологические процессы	технологический процесс
процессы	процесс
устройств	устройство
ядерный реактор	ядерный реактор
современный компьютер	современный компьютер
процессов	процесс
физических	физический
химических	химический
ЗППП	зпппа
сифилис	сифилис
приматов	примат
человека	человек
наземные сооружения	наземное сооружение
грузовых терминалов	грузовой терминал
пассажиров	пассажир
транзитных пассажиров	транзитный пассажир
предприятия	предприятие
ООО	ооо
подводные препятствия	подводное препятствие
части	часть
муниципальные образования	муниципальное образование
Российской Федерации	российская федерация
городские	городской
сельские поселения	сельское поселение
кредитно-финансовые учреждения	кредитно-финансовое учреждение
иностранных банков	иностранный банк
корпусов	корпус
костёл	костёл
значительные учёные	значительный учёный
Исаак Слепой	Исаак Слепой
Азриэль	азриэль
именами	имя
Моше Кордоверо	моше кордоверо
выдающихся каббалистов	выдающийся каббалист
Шалом Шавази	шалый шавази
Шалом Шараби	шалый шараби
Хаим Бен Атар	Хаим Бен Атар
особые состояния	особое состояние
сверхтекучее	сверхтекучее
плоды	плод
финики	финик
фиги	фига
высших растений	высочайшее растение
листья	лист
стебли	стебель
корни	корень
цветки	цветок
мякоть	мякоть
кожуру плодов	кожура плода
процессов	процесс
оплодотворение	оплодотворение
внешними факторами	внешний фактор
механическое повреждение	механическое повреждение
ранение	ранение
клетках животных	клетка животного
человека	человек
видов абстиненции	видов абстиненции
алкогольной	алкогольная
опиатной	опиатная
когнитивные функции	когнитивная функция
обучение	обучение
память	память
заболеваниях	заболевание
боковой	боковой
психических расстройств	психическое расстройство
шизофрения	шизофрения
депрессия	депрессия
вещества	вещество
кетамин	кетамин
заболеваний	заболевание
болезней печени	болезнь печень
анемий	анемия
сильных окислителей	сильный окислитель
перекиси водорода	перекиси водорода
хлорной кислоты	хлорная кислота
фосфолипидов	фосфолипид
синтез холина	синтез холина
лецитина	лецитин
приложений	приложение
текстовые процессоры	текстовый процессор
веб-браузеры	веб-браузер
почтовые программы	почтовая программа
мессенджеры	мессенджер
мультимедийные программы	мультимедийная программа
компьютерные игры	компьютерная игра
графические программы	графическая программа
среды разработки	среды разработки
бывших республиках	бывшая республика
домашних ПК в России	домашних ПК в России
электронные компоненты	электронная компонента
процессоры	процессор
особых государственных нужд	особая государственная нужда
военных	военный
рубежом	рубеж
сборку	сборка
современные ноутбуки	современный ноутбук
предназначенные	предназначенный
науками	наука
биология	биология
химия	химия
математика	математика
география	география
физика	физик
эпидемиология	эпидемиология
биогеохимия	биогеохимия
социология	социология
различные изменения	различное изменение
сезонные	сезонный
предметам	предмет
поведение	поведение
х годов	х год
труды	труд
экономической литературы	экономическая литература
земских статистических отчётов	земский статистический отчёт
деятелями	деятель
П. Лафаргом	п. лафарга
молодыми революционерами	молодой революционер
Мартовым	мартов
городов	город
социал-демократами Петербурга	социал-демократ петербурга
Москвы	москва
Нижнего Новгорода	нижний новгород
Воронежа	воронеж
остатков крепостничества в деревне	остатков крепостничества в деревне
возвращение крестьянам	возвращение крестьянин
материалах	материал
актах	акт
расследованиях	расследование
справках	справка
сводках	сводка
представителей интеллигенции	представителей интеллигенции
известных оппозиционных российских философов	известный оппозиционный российский философ
литераторов	литератор
родины	родина
членов семей	член семьи
радикальная демократизация	радикальная демократизация
выборность	выборность
сменяемость депутатов	сменяемость депутата
самобытными авторами	самобытный автор
Мишель Бютор	Мишель Бютор
учреждений	учреждение
американских университетов	американский университет
научных центров	научный центр
ответвления жанра	ответвления жанра
кибертрэш	кибертрэш
нанопанк	нанопанк
онлайн-продукты	онлайн-продукт
почтовый сервис	почтовый сервис
десктопные продукты	десктопный продукт
браузер	браузер
крупными инвесторами	крупный инвестор
венчурные компании	венчурная компания
эксплуатационные расходы	эксплуатационный расход
инвестиции в техническую инфраструктуру	инвестиции в техническую инфраструктуру
целях	цель
маркетинговых	маркетинговый
военных	военный
научных	научный
игровые манипуляторы	игровой манипулятор
педалями	педаль
целеуказатель в виде пистолета	целеуказатель в виде пистолета
интерактивных развлечений	интерактивное развлечение
кино	кино
телевидение	телевидение
названия	название
известны	известный
малоактивных металлов	малоактивный металл
золото	золото
платина	платина
палладий	палладий
условий	условие
температуры	температура
скорости испарения	скорость испарения
кожных заболеваний	кожное заболевание
псориаз	псориаз
озёра в Западной Сибири	озёра в Западной Сибири
Эльтонское	эльтонское
Баскунчак в Прикаспии	Баскунчак в Прикаспии
Кучукское озеро	кучукское озеро
Кулундинское озеро	кулундинское озеро
Эбейты	эбейт
ресурсов	ресурс
соляные источники	соляный источник
соляные озера	соляное озеро
ферментов	фермент
активность	активность
металлы	металл
хром	хром
марганец	марганец
железо	железо
кобальт	кобальт
никель	никель
понятия	понятие
добро	добро
зло	зло
религий	религия
иудаизм	иудаизм
христианство	христианство
ислам	ислам
сикхизм	сикхизм
наук	наука
социальной философии	социальная философия
истории философии	история философии
социологии	социология
антропологии	антропология
психологии	психология
всеобщей истории	всеобщая история
этнологии	этнология
археологии	археология
верований в сверхъестественное	верований в сверхъестественное
причины возникновения религий	причины возникновения религий
суеверий	суеверие
авторами	автор
Сэм Харрис	Сэм Харрис
Дэниел Деннет	дэниел деннеты
Ричард Докинз	ричард докинзы
Кристофер Хитченс	Кристофер Хитченс
Виктор Стенджер	Виктор Стенджер
приступов	приступ
эпилептических	эпилептический
событиями	событие
неумеренным постом	неумеренный пост
часть буддистов	часть буддиста
буддистов тхеравады	буддист тхеравада
школы	школа
сарвастивада	сарвастивад
элементы	элемент
причинно-зависимом происхождении	причинно-зависимое происхождение
необходимые вещи	необходимая вещь
монахам еду	монах еды
одежду	одежда
местными условиями	местное условие
климатическими	климатический
географическими	географический
социальными	социальный
подобных существ	подобное существо
демонов	демон
города	город
Адаб	адаба
Ниппур	ниппур
Лагаш	лагаша
Умма	умма
языки	язык
русский	русский
параллели	параллель
Библии	библия
сочинения	сочинение
театральную пьесу	театральная пьеса
Бруно	бруно
ближе	близкий
красящими примесями	красящая примесь
загрязнения углём	загрязнение угля
сверхъестественных существ	сверхъестественное существо
существования богов	существования богов
вечной жизни	вечная жизнь
человек	человек
тело	тело
человеческого естества	человеческое естество
телесное начало	телесное начало
разнообразных предметов	разнообразный предмет
масштабных объектов	масштабный объект
международных организаций	международная организация
рабочих языков ООН	рабочих языков ООН
ЮНЕСКО	юнеско
бывших республик	бывшая республика
России	россия
лиц	лицо
миллионами школьников	миллион школьника
студентов	студент
страны	страна
Канада	канада
США	сша
Германия	германия
Израиль	израиль
общеобразовательные структуры	общеобразовательная структура
российских вузов	российский вуз
странах	страна
Польше	польша
Чехии	чехия
Болгарии	болгария
Германии	германия
Норвегии	норвегия
Франции	франция
США	сша
Канаде	канада
Японии	япония
— в условиях влияния на русскую речь	— в условиях влияния на русскую речь
белорусский	белорусский
украинский	украинский
казахстанский	казахстанский
особенностей языков	особенностей языков
фонетических	фонетический
грамматических	грамматический
лексических	лексический
территории	территория
Нижнее Поволжье	нижнее поволжье
Кавказ	кавказ
Урал	урал
Сибирь	сибирь
Дальний Восток	дальний восток
городов	город
Новгорода	новгород
Смоленска	смоленск
Звенигорода-Галичского	звенигород-галичское
существительные	существительное
собирательные —	собирательный —
русского языка	русский язык
А. А.	А. А.
падежей	падеж
предложного	предложный
категориями	категория
вид	вид
залог	залог
наклонение	наклонение
время	время
лицо	лицо
число	число
род	род
средств	средство
формы	форма
учёные	учёный
Л. И.	Л. И.
исследователи	исследователь
А. Х.	А. Х.
славянских языков	славянский язык
русского	русский
именами	имя
Ф. Ф.	Ф. Ф.
работ	работа
грамматики	грамматика
промышленных газов	промышленный газ
осушке воздуха	осушка воздуха
углекислого газа	углекислая газа
водорода	водород
кислорода	кислород
азота	азот
хлора	хлор
силикатные материалы	силикатный материал
стекло	стекло
боги	бог
Эйя в аккадской мифологии	Эйя в аккадской мифологии
Хнум в египетской мифологии	Хнум в египетской мифологии
Ульгем в алтайской мифологии	Ульгем в алтайской мифологии
Амма в мифологии догонов	Амма в мифологии догонов
Иоскеха в ирокезской мифологии	Иоскеха в ирокезской мифологии
сюжеты	сюжет
поколений	поколение
гибель богов	гибель бога
календарными событиями	календарное событие
Нового года	новый год
праздниками урожая	праздник урожая
страхи	страх
массовые	массовый
культурных феноменов	культурный феномен
индоевропейских мифов	индоевропейский миф
старых научных школ	старая научная школа
мифологической фольклористики	мифологическая фольклористика
языческих традиций	языческая традиция
шаманизм	шаманизм
боги	бог
Амона	амон
наукам	наука
архитектуру	архитектура
богов	бог
Анубиса	анубиса
Упуаута	упуаут
свойства	свойство
точке плотность	точка плотности
науках	наука
географии	география
физике	физика
вопросы	вопрос
динамика	динамик
науками	наука
инженерной геологией	инженерная геология
метеорологией	метеорология
геохимией	геохимия
геофизикой	геофизика
нитрогенных остатков	нитрогенный остаток
доступности аммиака	доступности аммиака
ферментами	фермент
глутамат-дегидрогеназа	глутамат-дегидрогеназа
млекопитающих	млекопитающее
человека	человек
аммиак	аммиак
недопустимым в определённых областях	недопустимым в определённых областях
научные публикации	научная публикация
тексты законов	текст закона
техническая документация	техническая документация
разделах физики	раздел физики
термодинамика	термодинамика
электромагнетизм	электромагнетизм
квантовая физика	квантовый физик
феноменологические характеристики	феноменологическая характеристика
удельное сопротивление	удельное сопротивление
исследователей	исследователь
Галилео Галилей	галилео галили
Христиан Гюйгенс	христиана гюйгенса
Иоганн Кеплер	Иоганн Кеплер
Блез Паскаль	блёз паскаля
кинематики	кинематика
закон инерции	закон инерции
новые явления	новое явление
рентгеновские лучи	рентгеновский луч
радиоактивность	радиоактивность
методы	метод
рентгеновские	рентгеновский
ультразвуковые исследования	ультразвуковое исследование
отраслях	отрасль
тяжелое машиностроение	тяжёлое машиностроение
автомобилестроение	автомобилестроение
продуктов	продукт
воздействием альфа-частиц	воздействие альфа-частицы
масляных веществ	масляное вещество
жира	жир
примеси	примесь
гипс	гипс
органические восстановители	органический восстановитель
щавелевая	щавелевая
муравьиная кислоты	муравьиная кислота
спектр восстановителей	спектр восстановителя
органических	органический
шире	шире
параметры	параметр
инструменты	инструмент
приёмы	приём
юго-западные земли	юго-западная земля
Смоленск	смоленск
Брянск	брянск
Курск	курск
земель	земеля
Литве Киевщины	литва киевщины
народов	народ
армян	армянин
итальянцев	итальянец
венгров	венгров
языков	язык
использование в делопроизводстве	использование в делопроизводстве
местах	место
Минске	минск
Копыле	копыль
Плунге	плунге
Койданове	койданов
Любче	любкий
Ивенце	ивенец
Ретавасе	ретавас
ний	ний
супружескую близость	супружеская близость
категории мусульман	категории мусульман
кормящие женщины	кормящая женщина
путники	путник
священных мест	священное место
Марва	маров
христианские догматы	христианский догмат
Троица	троица
Боговоплощение	боговоплощение
приверженцы	приверженец
ваххабиты	ваххабит
религиозные дисциплины	религиозная дисциплина
коранистика	коранистика
античной философии	античная философия
аристотелизма	аристотелизм
правовых систем	правовая система
современного законодательства	современное законодательство
различные культурные традиции	различная культурная традиция
философско-научное наследие	философско-научное наследие
богословов	богослов
ат-Табари	ат-табари
Абу-ль-Фариси	абу-ль-фарися
странах	страна
Средней Азии	средняя азия
Китае	китай
Турции	турция
частях мира	часть мира
Австралии	австралия
религиозные положения	религиозное положение
дхарма	дхарма
карма	карма
сансара	сансар
майя	майя
мокша	мокша
йога	йог
странах	страна
Бангладеш	бангладеш
Шри-Ланка	шри-ланка
Пакистан	пакистан
Индонезия	индонезия
Малайзия	малайзия
Сингапур	сингапур
Маврикий	маврикий
Фиджи	фиджи
Суринам	суринам
Гайана	гайана
Тринидад	тринидад
Тобаго	тобаго
направления в индуизме	направления в индуизме
ганапатья	ганапатье
индоевропейскими религиями	индоевропейская религия
зороастризмом	зороастризм
классические индуистские мотивы	классический индуистский мотив
любовные истории	любовная история
практики индуизма	практики индуизма
поклонение мурти	поклонение мурти
аватарам	аватар
Кришне	кришна
Раме	рам
учёные	учёный
Макс Мюллер	Макс Мюллер
Джон Вудрофф	Джон Вудрофф
популярные индусские практики	популярная индусская практика
поклонение мурти	поклонение мурти
харизматичных духовных лидеров	харизматичный духовный лидер
Рамакришна	рамакришна
церемоний	церемония
свадьба	свадьба
похороны	похороны
посвящение в ученики	посвящение в ученики
событий	событие
рождение ребёнка	рождение ребёнка
свадьба	свадьба
похороны	похороны
обряды	обряд
аннапрашана	аннапрашан
особенности	особенность
помолвка	помолвка
социальные реформаторы	социальный реформатор
Махатма Ганди	махатм ганди
процессов	процесс
санскритизация	санскритизация
урбанизация	урбанизация
использования украшений	использования украшений
бинди	бинди
течения в индуизме	течения в индуизме
гаудия-вайшнавизм	гаудия-вайшнавизм
идеи	идея
карма	карма
йога	йог
вегетарианство	вегетарианство
обозначения вещей	обозначения вещей
квест	квеста
живых организмов	живой организм
животных	животное
гидроксильной группы	гидроксильная группа
велико на соединения	велико на соединения
соединений	соединение
углеводороды	углеводород
галогеналканы	галогеналкан
амины	амин
карбонильные соединения	карбонильное соединение
эпоксиды	эпоксид
внешние факторы	внешний фактор
природа растворителя	природа растворителя
гликоли	гликоль
этанол	этанол
этиленгликоль	этиленгликоль
лекарственных средств	лекарственное средство
салол	салол
валидол	валидол
змеи семейства аспидов	змеи семейства аспидов
кобр	кобра
змей	змей
аспидов	аспид
ехидн	ехидна
василисков	василиск
авторы	автор
Акимушкин	акимушкин
детей	ребёнок
проклятых матерью	проклятая матерь
изменённых состояниях	изменённое состояние
сновидениях	сновидение
помрачениях ума	помрачение ума
забытьи	забытьё
живым людям	живой человек
детям	ребёнок
средств	средство
матерной брани	матерная брань
оберегов	оберег
огнестрельного оружия	огнестрельное оружие
заряженного	заряжённый
проклятие	проклятие
родительское	родительское
персонажи	персонаж
Карачун	карачун
Трескун	трескун
Студенец	студенец
Морозко	морозко
праздничных представлений	праздничное представление
новогодних ёлок	новогодняя ёлка
образа оборотней	образ оборотня
заражение	заражение
животных	животное
виде коровы	вид коровы
коня	конь
телёнка	телёнок
собаки	собака
зайца	заяц
сильных антибактериальных химиопрепаратов	сильный антибактериальный химиопрепарат
фторхинолонов	фторхинолон
заболеваний	заболевание
брюшного тифа	брюшной тиф
дизентерии	дизентерия
антибиотики	антибиотик
метронидазол	метронидазола
тинидазол	тинидазол
левомицетин	левомицетин
ко-тримоксазол	ко-тримоксазол
цефамандол	цефамандола
кетоконазол	кетоконазол
латамоксеф	латамоксеф
цефоперазон	цефоперазон
цефменоксим	цефменоксим
фуразолидон	фуразолидон
союзных республик	союзная республика
МССР	мсср
русские писатели	русский писатель
Фёдора Достоевского	Фёдора Достоевского
Марину Цветаеву	Марину Цветаеву
Александра Солженицына	Александра Солженицына
мастеров	мастер
произведения Андрея Рублёва	произведения Андрея Рублёва
Дионисия	дионисий
Симона Ушакова	Симона Ушакова
городах России	город россии
памятников культуры в Петрограде	памятников культуры в Петрограде
ферромагнитных элементах	ферромагнитный элемент
железо	железо
нечётное число	нечётное число
стран ЕС	стран ЕС
Эстонию	эстония
реформы	реформа
губная	губная
земская	земская
встречных городах	встречный город
грабежи в Твери	грабежи в Твери
Клину	клин
Торжке	торжок
города	город
Великие	великий
музыкальные мастера	музыкальный мастер
Фёдор Крестьянин	Фёдор Крестьянин
месяц	месяц
счастливый в жизни императора	счастливый в жизни императора
авторов	автор
Ф. Лассаля	Ф. Лассаля
П. Б.	П. Б.
Засулич	засулич
странах	страна
перестройке в СССР	перестройке в СССР
Германии	германия
Людендорфа	людендорф
Гитлера	гитлер
музыкальных произведений	музыкальное произведение
автор балетов	автор балета
симфоний	симфония
мюзиклов	мюзикл
музыканты	музыкант
Колин Дэвис	Колин Дэвис
звёзды	звезда
Солнце	солнце
космических тел	космическое тело
звёзд	звезда
Солнца	солнце
планет	планета
цифровыми детекторами	цифровой детектор
детекторами на основе приборов	детекторами на основе приборов
межзвездным газом	межзвёздный газ
спектральная линия	спектральная линия
космических объектов	космический объект
сверхновые звезды	сверхновая звезда
межзвездный газ	межзвёздный газ
пульсары	пульсар
активные	активный
спутниками	спутник
Телескоп Комптон	Телескоп Комптон
тел	тело
излучения Солнца	излучения Солнца
физическая космология	физическая космология
космология струн	космология струны
астрофизика	астрофизик
тысяч участников	тысяч участников
президента России	президента России
проявления	проявление
множества народа	множества народа
социальными требованиями	социальное требование
часового рабочего дня	часовой рабочий день
организации	организация
коммунисты	коммунист
анархисты	анархист
представителями власти Бонч-Бруевич	представитель власти бонч-бруевича
Лениным	ленин
праздничных мероприятий	праздничное мероприятие
кораблей	корабль
парадов	парад
фактами	факт
домашнее насилие в отношении женщин	домашнее насилие в отношении женщин
занижение	занижение
ценнейшие промысловые виды	ценнейший промысловый вид
белуга	белуга
севрюга	севрюга
сельдь	сельдь
рыбец	рыбец
русский осётр	русский осётр
бестер	бестёрший
шемая	шемая
массовые виды	массовый вид
судак	судак
лещ	лещ
тарань	тарань
чехонь	чехонь
рыбы	рыба
стерлядь	стерлядь
серебряный	серебряный
